1
e1m1.jpg
11102220
10102020
10102020
10102020
11102020
10002222
10002002
10002002
10002002
10002002
10002222
00000000
00000000
00000000
00000000
00000000