2
e1m1.jpg
11311121
11111111
12111121
11111111
11111311
11111111
11211113
11111111
11111211
33111111
11111111
00000000
00000000
00000000
00000000
00000000