2
woodie.png
11111111
11122111
12000021
11000011
21122112
01111110
02022020
01033010
22222222
00000000
00000000
00000000
00000000
00000000
00000000
00000000