3
nave.png
01022002
01002210
13100010
11100131
01000111
00202010
20020002
20210002
02131020
00111200
20010002
00000000
00000000
00000000
00000000
00000000