4
astroneer.png
00022000
00211200
02133120
01300310
02000020
02011020
02133120
02300320
02000020
12111121
12111121
00000000
00000000
00000000
00000000
00000000