5
blue-valley.png
00010000
00121000
01202100
10210210
22021021
02102102
10210210
03031031
00103100
00210200
00021000
00000000
00000000
00000000
00000000
00000000